%%%%%%%%%%%%%%%%%%%%%%%%%%%%%%%%%%%%%%%%%%%%%%%%%%%%%%%%%%%%%%%
%   . ..... ....  ......  ..    .. .. .......%... .......% .. %
%  %%%%%%%%% .  .  .  .  . .     % .. . .%  .. ..%%%%%%%%%    %
%                                                             %
%                  %        %   %%%%%%%%%        %%%%%%%%%%   %
%  %%%%%%%%%                         %        %               %
%    .     .       .     .  %        %   .     .      .       %
%   . .    .         . .  .                .     .      .     %
%                           %        %           ..    .    . %
%%%%%%%%%%%%%%%%%%%%%%%%%%%%%%%%%%%%%%%%%%%%%%%%%%%%%%%%%%%%%%% 